##########################     #########
#      #                               #
#      #                               #
#      #                               #
###  ###                               #
#                                      #
#                                      #
#                                      #
#                                      #
#                                      #
#                                      #
#                                      #
#                                      #
#            #####  ####################
#            #                #        #
#            #                #        #
#            #                #        #
#            #                #        #
#            #                          
########################################