########################################
#                                      #
#    aaaaa                             #
#    a   a                             #
#    aaaaa                             #
#                                      #
#                                      #
#                                      #
#                                      #
#                                      #
############   #########################