  #     #   #####   #      #
   #   #   #     #  #      #
    ###    #     #  #      #
     #     #     #  #      #
     #     #     #  #      #
     #     #     #   #    #
     #      #####     ####
 
###############################
#                             #
#                             #
#                             #
###############################

     #     #    ###   #   #
     #     #     #    ##  #
     #  #  #     #    # # #
      # # #      #    #  ##
       ###      ###   #   #          